SOOOOOOOOOOOOWW
WWWOWWWWOWWOOOO
WWWOOOOOOOOWWWO
WWWOWWOOWWOOOOW
OOOOWWWWOOOOWOW
OOWOOOOWWWOWWOO
WOWWWWOWWWOWWWW
WOOOOOOOOWOOOWW
WWOOWWOWWWWWOWW
WOOOWWWWOOOOOWW
WWWOWWOWWWWOOOO
WOOOWWOOOOWWWWO
WOWWWWOWWOOOOOO
WOOOWWOOOOOWWOO
WWWOOOOWWWOOOOE
