SOOOWWWWWWWWWWW
WWWOWWWWWWWWWWW
WWWOWWWWWWWWWWW
WWOOWWWWWWWWWWW
WWOOWWWWWWWWWWW
WWOWOOOOOOOWWWW
WWOOWWWWWWOWWWW
WWWOWWOWWWOWWWW
WWWOWWOWWWOWWWW
WWWOWWWWWWOWWWW
WWWOOOOWWWOWWWW
WWWWWWOOOOOOOWW
WWWWOOOWWOWWOWW
WWWWOWWWWWWWWWW
WWWWOOOOOOOOOOE
