S............##
###.####.##....
###........###.
###.##..##....#
....####....#.#
..#....###.##..
#.####.###.####
#........#...##
##..##.#####.##
#...####.....##
###.##.####....
#...##....####.
#.####.##......
#...##.....##..
###....###....E
